
GRM = "countries/Salem's Faction.txt"
ATL = "countries/Kingdom of Atlas.txt"
VAL = "countries/Vale.txt"
VAC = "countries/Kingdom of Vacuo.txt"
MIS = "countries/Kingdom of Mistral.txt"
WTF = "countries/White Fang.txt"
MEN = "countries/Menagerie.txt"
BRA = "countries/Branwen Tribe.txt"
CRI = "countries/Crime Syndicate.txt"
FAR = "countries/Far Land Villages.txt"
FAL = "countries/The Fallen Kingdom.txt"
TLK = "countries/The Lost Kingdom.txt"


MMH = "countries/Solitas Megoliath Hoard.txt"
MMM = "countries/Solitas Manticore Hoard.txt"
MSP = "countries/Solitas Sabyrs Pack.txt"
MBP = "countries/Solitas Beowolves Pack.txt"
SNN = "countries/Emerald Forest Nevermore Nest.txt"
NSB = "countries/Northern Sanus Beowolves Pack.txt"
SMH = "countries/Sanus Megoliath Hoard.txt"
EUP = "countries/Emerald Forest Ursa Pack.txt"
DSN = "countries/Death Stalkers Nest.txt"
SBN = "countries/Northern Sanus Boarbatusks Nest.txt"
MGC = "countries/Mountain Gleen Creep.txt"
SWL = "countries/Sanus Wyvern's Layer.txt"
UNP = "countries/Ursa Northern Pack.txt"

MSC = "countries/Mistral Sanus Colony.txt"
VEC = "countries/Vale Eastern Colony.txt"
VSC = "countries/Vale Southern Colony.txt"
MNC = "countries/Mistral Northern Colony.txt"
MCC = "countries/Mistral Southern Colony.txt"

DDS = "countries/Desert Death Stalkers Nest.txt"
KTN = "countries/King Taijitu Nest.txt"
SLN = "countries/Sanus Lancer Nest.txt"
SRN = "countries/Raveger Nest.txt"
USP = "countries/Ursa Southern Pack.txt"
SBP = "countries/Southern Sanus Beowolves Pack.txt"
SSP = "countries/Anima Sabyr Pack.txt"
NAB = "countries/Northern Anima Beowolves Pack.txt"
SAB = "countries/Southern Anima Beowolves Pack.txt"
AMH = "countries/Anima Manticore Hoard.txt"
ASP = "countries/Anima Sphinx Pack.txt"
AAP = "countries/Anima Apathy Pack.txt"
ALN = "countries/Anima Lancers Nest.txt"
ANN = "countries/Anima Nevermores Nest.txt"
AUP = "countries/Anima Ursai Pack.txt"

CRT = "countries/Clan Ren Tribe.txt"
CST = "countries/Clan Siliver Tribe.txt"
DWL = "countries/Dragcis Wyvern's Layer.txt"
DBP = "countries/Dragcis Beowolves Pack.txt"
DNN = "countries/Dragcis Nevermore Nest.txt"
UUP = "countries/Unorganized People.txt"